KodiPortugal.pt (http://epg.kodiportugal.com)
ID's:

[NOME DO CANAL] - [ID]

RTP1 – rtp1.pt
RTP2 – rtp2.pt
SIC – sic.pt
TVI – TVI.pt
RTP3 – rtpn.pt
SICN – sicnoticias.pt
TVI24 – TVI24.pt
CMTV – CMTV.pt
ECONOMICO TV – EconomicaTV.pt
EURONEWS – Euronews.nws
CNN – CNN
CANAL PARLAMENTO (ARTV) – ARTV.pt
RTP MEMÓRIA – rtpmemoria.pt
RTP MADEIRA – RTPMadeira.pt
RTP ACORES – RTPAcores.pt
RTP AFRICA – RTPAfrica.pt
SIC MULHER – sicmulher.pt
SIC RADICAL – sicradical.pt
SIC CARAS – SicCaras.pt
TVI FICÇÃO – TVIFiccao.pt
PORTO CANAL – PortoCanal.pt
TPA – TPA
TV CABO VERDE – TCV
TV RECORD – TVRECORD
24Kitchen – 24Kitchen.pt
CANÇÃO NOVA – CancaoNova.PT
TLC – TLC.pt
AXN – axn.pt
AXN BLACK – AXNBlack.pt
AXN WHITE – AXNWhite.pt
FOX – fox.pt
FOX CRIME – foxcrime.pt
FOX LIFE – foxlife.pt
FOX MOVIES – FOXM
HOLLYWOOD – hollywood.pt
TVCine1 – TVCine1.pt
TVCine2 – TVCine2.pt
TVCine3 – TVCine3.pt
TVCine4 – TVCine4.pt
TVSeries – TVSeries.pt
SYFY – SyFy.pt
CINEMUNDO – CINEMUNDO
FOX COMEDY – FOXComedy.pt
NAT GEO – nationalgeographic.pt
NAT GEO WILD – NGWIL
DISCOVERY – discoverychannel.pt
TRAVEL CHANNEL – TRV
ODISSEIA – odisseia.pt
HISTORIA – HistoryChannel.pt
Localvisão TV – LVTV
PANDA – canalpanda.pt
PANDA BIGGS – PandaBiggs.pt
DISNEY JR – disneyjunior.pt
DISNEY CHANNEL – disneychannel.pt
BABY FIRST TV – BABYT
CARTOON NETWORK – CART
JIMJAM – JJAM
SICK – SICK.pt
MTV – mtvportugal.pt
E! – E!
VH1 – VH1
MCM TOP – MCMTOP
C-MUSIC – C-MUS
AFRO MUSIC – AFRO
TRACE – TRACE TV
FTV  (Fashion TV Network’s) – FTV
LUXE TV HD – LUXHD
CBS REALITY – CBSR
MCS LIFESTYLE – MCSL
DOGTV – DOGTV
GLOBO PREMIUM – GLOBO
A BOLA TV – ABolaTV.pt
SPORT TV 1 – sporttv1.pt
SPORT TV 2 – sporttv2.pt
SPORT TV 3 – sporttv3.pt
SPORT TV 4 – sporttv4.pt
SPORT TV 5 – sporttv5.pt
BENFICA TV – BenficaTV.pt
BENFICA TV 2 – BenficaTV2.pt
SPORTING TV – SPORTINGTV.pt
Manchester United TV – ManUTV.pt
Real Madrid TV – RMTV.pt
EUROSPORT (POR) – eurosport.pt
EUROSPORT 2 – eurosport2.pt
TOROTV – TOROTV.pt
PLAYBOY TV – PLAY
VÉNUS – VENUS
HOT – HOT
PFC – PFC
AMC – AMC
CNBC EUROPE – CNBC
A&E – AE
FOOD NETWORK – FOOD
TV Record – TVREC
Eurosport News – EURSN
Motors TV – MOTOR
Bloomberg – BLOOM
Aljazeera – ALJAZ
FR24 – FR24F
